szczególnie (p) - particularly
koszty ogólne (o) - overheads
konkurent - competitor
podarunek (g) - gift
zawieraæ (i) - include
zachêcaæ - encourage
uczestnik (p) - participant
udzia³ w rynku - market share
oceniæ (e) - evaluate
rozs¹dny (s) - sensible
pojawiaæ siê - appear
zbiæ kapita³ na - capitalise on
cyfrowy - digital
wizerunek - image
ciekawoœæ (c) - curiosity
swobodny (c) - casual
unikalny (u) - unique
robiæ burzê mózgów - brainstorm
poziom (l) - level
wypuœciæ na rynek (l) - launch
rozdmuchaæ, zrobiæ du¿o szumu (h) - hype
przyci¹gaæ (a) - attract
przybory toaletowe - toiletries
zdobyæ punkty (s) - score
maj¹cy znaczenie, istotny, odpowiedni (r) - relevant
odpowiedni (s) - suitable
umawiaæ siê na randki - date
lojalnoœæ klienta - customer loyalty
redukowaæ - reduce
kierowaæ do (t) - target
uczêszczaæ - attend
kampania reklamowa - advertising campaign
udany (s) - successful
wywiesiæ (p) - post
wejœcie na stronê (h) - hit
cel (a) - aim
ekscytowaæ - excite
posiad³oœæ (m) - mansion
pachnieæ - smell
udaæ siê, powieœæ siê (s) - succeed
darmowa próbka - free sample
media spo³ecznoœciowe - social media
porównaæ - compare
reklamowaæ - advertise
szukaæ (s) - seek
rozg³os (p) - publicity
zwyk³y (o) - ordinary
intryga - intrigue
umiejêtnoœæ - skill
rozpoznanie (r) - recognition
urywek (e) - extract
zaproszenie - invitation
po³¹czyæ (c) - combine
osi¹gn¹æ (r) - reach
strona internetowa (w) - website
gracz - player
sztuczka, wybieg (p) - ploy
rozdawaæ (h) (ph.v.) - hand out
wschodz¹cy rynek (e/m) - emerging market
œwiadomoœæ marki - brand awareness
promowaæ - promote
przejœæ na drug¹ stronê (c) (ph.v.) - cross over
zainteresowanie - interest
bezpoœrednia wysy³ka (d/m) - direct mail
loteria - lottery
segment cenowy - price segment
krytykowaæ - criticise
atrakcja - attraction
wada - disadvantage
reklama, reklamowanie - advertising
opis - description
zapobiegaæ (p) - prevent
œrodowisko, pochodzenie, wykszta³cenie (b) - background
efektywnoœæ - effectiveness
pewien (c) - certain
dewiza, has³o (w) - watchword
odkrycie (d) - discovery
nadawaæ, emitowaæ (b) - broadcast
docelowa grupa odbiorców (t/a) - target audience
p³aciæ wy¿sz¹ cenê - pay a premium
marka w³asna - own brand
wejœæ, rozpocz¹æ (e) - enter
ulotka - leaflet
lojalny - loyal
t³um - crowd
wyst¹piæ (f) - feature
twórczy - creative
przemawiaæ do, podobaæ siê - appeal to
za³o¿yæ (e) - establish
dezodorant - deodorant
szampon - shampoo
zastosowaæ (a) - apply
rozwa¿yæ (c) - consider
strategia marketingowa - marketing strategy
lokalizacja, po³o¿enie (l) - location
oprogramowanie (s) - software
sponsorowanie - sponsorship
zaleta - advantage
dostawca - supplier
broszura - brochure
skupiæ siê na - focus on
najwiêksza atrakcja (c) (11) - centrepiece
rozwijaæ siê, powiêkszaæ siê (e) - expand
iloœæ (q) - quantity
przystêpny (a) - affordable
