centrum szkoleniowe - training centre
uwaga (a) - attention
uznanie (r) - recognition
zasoby ludzkie - human resources
³owca g³ów - headhunter
zapytanie (e) - enquiry
szczególny (p) - particular
intensywny - intensive
ci¹g³y, sta³y, nieustaj¹cy (c) - continuous
wewnêtrzny - internal
zachêcaæ - encourage
priorytet - priority
kultywowaæ - cultivate
rozpraszaæ (d) - distract
detalista - retailer
oczekiwaæ - expect
oddany, gorliwy (d) - dedicated
godziny pracy - working hours
kultura organizacyjna - corporate culture
wierzenie - belief
zatrzymaæ (r) - retain
robiæ wra¿enie - impress
nadgodziny - overtime
kierownik wy¿szego szczebla (s/e) - senior executive
atrakcyjny - attractive
bezpieczeñstwo (6) - safety
okazja, sposobnoœæ (o) - opportunity
zdobyæ (g) - gain
strona internetowa (w) - website
rozwijaæ (d) - develop
personel (s) - staff
pracownik (e) - employee
pensja (s) - salary
nowy pracownik (r) - recruit
pasowaæ (s) - suit
niezbêdny, zasadniczy (e) - essential
fundamentalny, podstawowy (c) - core
kluczowy - key
zakres (r) - range
absolwent (g) - graduate
oddanie, zaanga¿owanie (c) - commitment
zatrudniæ (ph.v.) - take on
przy³¹czyæ siê - join
decyduj¹cy, rozstrzygaj¹cy (c) (7) - crucial
szkolenie - training
rekrutacja - recruitment
obecnie (c) - currently
wiedza - knowledge
rozmaity (d) - diverse
kierunek - direction
wymagaæ - require
odpowiedzialnoœæ - responsibility
w firmie, na miejscu - in-house
bodziec - incentive
awansowaæ (p) - promote
wymagania - requirements
na miarê - tailor-made
czêœciowo - partly
bud¿et szkoleniowy - training budget
wspomnieæ, wymieniæ (m) - mention
udany (s) - successful
trwaæ - last
stopieñ - degree
okreœlanie celów (g/s) - goal setting
udaæ siê, odnieœæ sukces (s) - succeed
troska (c) - concern
profesjonalizm - professionalism
zaawansowany - advanced
uczêszczaæ (a) - attend
konsekwentny (c) - consistent
prowadziæ, przewodziæ (l) - lead
premia, dodatek (b) - bonus
doskona³oœæ (e) - excellence
niezale¿ny - independent
arkusz kalkulacyjny - spreadsheet
przywództwo (l) - leadership
chêtny (w) - willing
zachowywaæ siê - behave
rozwój (d) - development
awans - promotion
cierpliwy - patient
sta³y (p) - permanent
wspinaæ siê mozolnie po szczeblach kariery - shuffle up the ladder
brakowaæ (l) - lack
analiza - analysis
mieæ na celu (a) - aim
ubiegaæ siê o - apply for
zarz¹dzanie czasem - time management
urz¹dzenia, udogodnienia (f) - facilities
rozwój, wzrost (e) - expansion
zapewniæ, dostarczyæ (p) - provide
kariera - career
szybki, nag³y (r) - rapid
prowadziæ, przewodziæ (g) - guide
polityka - policy
zespó³ - team
zawieraæ (i) - include
wsparcie (s) - support
sprzeda¿ - sales
stopieñ, ranga, stanowisko (r) - rank
broszura - brochure
produktywnoœæ - productivity
sfrustrowany - frustrated
pocz¹tkowy (i) - initial
cele szkoleniowe (l/g) - learning goals
bezpoœrednio (d) - directly
œcie¿ka - path
oferta cenowa (q) - quotation
zewnêtrzny - external
