dostêpnoœæ - availability
umiarkowany, œredni (m) - moderate
rozwi¹zaæ - solve
rezerwacja (r) - reservation
wymagania - requirements
nieformalny - informal
rozstrzygaj¹cy, zasadniczy (c) (7) - crucial
stawka (r) - rate
dzwoni¹cy (c) - caller
odnosiæ siê do (r) - refer to
wakat - vacancy
faktura - invoice
przychodz¹cy (i) - incoming
instynktowny - instinctive
podœwiadomy - subconscious
martwiæ siê o - worry about
skorzystaæ na - benefit from
zez³oœciæ (a) - annoy
jêzyk cia³a - body language
kandydat (rozmowa o pracê) (i) - interviewee
formalny - formal
zwracaæ uwagê na - pay attention to
cel (p) - purpose
wzmocniæ (r) - reinforce
g³oœnoœæ (v) - volume
przedstawiæ - introduce
g³os - voice
niegrzeczny (r) - rude
pobraæ, naliczyæ op³atê (c) - charge
dok³adnie (a) - accurately
zawodowy (o0 - occupational
ubraæ siê (d) - dress
rozpowszechniæ (c) - circulate
osi¹gn¹æ - achieve
stanowisko (4) (p) - post
profesjonalny - professional
mieæ znaczenie (m) (6) - matter
zapytaæ (e) - enquire
zarezerwowaæ (b) - book
brzmieæ - sound
cena - price
konferencja - conference
podprogowy (s) - subliminal
wolno - slowly
stanowiæ (a) - account for
pisaæ na klawiaturze (t) - type
znacznie (c) - considerably
ksiêgowoœæ, buchalteria (b) - bookkeeping
dodzwoniæ siê do (r) - reach
wymyœliæ (i) - invent
obowi¹zek (d) - duty
s³ownictwo - vocabulary
pochlebny (f) - favourable
zwiêz³y (b) - brief
przygotowanie - preparation
uœcisk d³oni - handshake
odbiorca (r) - recipient
ró¿nica - difference
towarzyszyæ (a) - accompany
decyduj¹cy (c) (8) - critical
psycholog - psychologist
przetwarzaæ (p) - process
wyraŸnie (c) - clearly
zapewniæ (e) - ensure
grzecznie - politely
wygl¹d (a) - appearance
odpowiedzieæ (r) (5) - reply
