podatek - tax
uczestniczyæ w (p) - participate in
pokolenie - generation
przepustka - pass
ni¿szy rang¹ (j) - junior
daj¹cy satysfakcjê (f) - fulfilling
pracownik (e) - employee
dyscyplina - discipline
wysi³ek - effort
wyniki, wydajnoœæ (p) - performance
zatrudniaæ (ph.v.) - take on
rozwi¹zanie - solution
zajmowaæ siê czymœ, dawaæ sobie radê z (d) - deal with
ambicja - ambition
wolnoœæ - freedom
wydaæ (i) - issue
popularnoœæ - popularity
poczucie - sense
kasa (supermarket) - checkout
satysfakcja - satisfaction
równowa¿yæ - balance
pierwsze wra¿enie - first impression
zakres obowi¹zków (j/d) - job description
rekrutowaæ - recruit
utrzymaæ, zachowaæ (m) - maintain
s¹dziæ, oceniaæ (j) - judge
promowaæ - promote
cz³onek - member
porozumienie, zgoda (a) - agreement
sk³adaæ siê z - consist of
bud¿etowanie - budgeting
prosperowaæ na (t) (ph.v.) - thrive on
ksiêgowy - accountant
nabyæ, zdobyæ (a) - acquire
praca papierkowa - paperwork
rozmaitoœæ (v) - variety
ostateczny termin - deadline
nadzorowaæ (s) - supervise
powód - reason
wartoœæ (v) - value
zysk - profit
przykleiæ, przyczepiæ, trzymaæ siê (s) - stick
podpisaæ - sign
ksiêgowoœæ (a) - accountancy
liczby (f) - figures
uwa¿aæ (r) - regard
iloœæ (a) - amount
inwestycja - investment
zadanie (t) - task
jakoœæ - quality
obliczyæ - calculate
projektowaæ (d) - design
wiadomoœæ - message
rozprowadzaæ (d) - distribute
og³osiæ - announce
wybór (c) - choice
ambitny - ambitious
duma - pride
wyobraziæ sobie - imagine
poprawiæ, polepszyæ (i) - improve
twierdzenie, oœwiadczenie (s) - statement
wa¿noœæ (i) - importance
entuzjastyczny - enthusiastic
rozwój, postêpy (p) (11) - progression
postêp (p) (8) - progress
technologia - technology
cenny (v) - valuable
raport - report
miejski (u) - urban
sieæ (sklepów) (c) - chain
zapisy finansowe (f/r) - financial records
