miejski (u) - urban
przekonaæ - persuade
postêp (p) (8) - progress
podatek - tax
ni¿szy rang¹ (j) - junior
praca papierkowa - paperwork
raport - report
rozprowadzaæ (d) - distribute
prosperowaæ na (t) (ph.v.) - thrive on
dyscyplina - discipline
zmiennik (r) - relief
przepustka - pass
technologia - technology
inwestycja - investment
zatrudniaæ (ph.v.) - take on
ostateczny termin - deadline
ambitny - ambitious
podpisaæ - sign
kampania promocyjna - promotional campaign
duma - pride
projektowaæ (d) - design
ambicja - ambition
cz³onek - member
wa¿noœæ (i) - importance
zajmowaæ siê czymœ, dawaæ sobie radê z (d) - deal with
kasa (supermarket) - checkout
uwa¿aæ (r) - regard
zakres obowi¹zków (j/d) - job description
twierdzenie, oœwiadczenie (s) - statement
sk³adaæ siê z - consist of
pracownik (e) - employee
nabyæ, zdobyæ (a) - acquire
wolnoœæ - freedom
s¹dziæ, oceniaæ (j) - judge
powód - reason
jakoœæ - quality
og³osiæ - announce
wydaæ (i) - issue
zapisy finansowe (f/r) - financial records
iloœæ (a) - amount
utrzymaæ, zachowaæ (m) - maintain
wyniki, wydajnoœæ (p) - performance
wartoœæ (v) - value
popularnoœæ - popularity
ksiêgowy - accountant
przykleiæ, przyczepiæ, trzymaæ siê (s) - stick
wysi³ek - effort
bud¿etowanie - budgeting
równowa¿yæ - balance
liczby (f) - figures
rozmaitoœæ (v) - variety
rekrutowaæ - recruit
ksiêgowoœæ (a) - accounting
pokolenie - generation
porozumienie, zgoda (a) - agreement
ambitny, bêd¹cy wyzwaniem - challenging
wiadomoœæ - message
satysfakcja - satisfaction
poczucie - sense
entuzjastyczny - enthusiastic
daj¹cy satysfakcjê (f) - fulfilling
poprawiæ, polepszyæ (i) - improve
uczestniczyæ w (p) - participate in
pierwsze wra¿enie - first impression
wybór (c) - choice
zysk - profit
rozwój, postêpy (p) (11) - progression
cenny (v) - valuable
rozwi¹zanie - solution
zadanie (t) - task
obliczyæ - calculate
sieæ (sklepów) (c) - chain
nadzorowaæ (s) - supervise
wyobraziæ sobie - imagine
promowaæ - promote
