broszura - brochure
zatrudniæ (ph.v.) - take on
priorytet - priority
kultywowaæ - cultivate
prowadziæ, przewodziæ (g) - guide
atrakcyjny - attractive
stopieñ - degree
wymagaæ - require
umiejêtnoœæ (s) - skill
praktykant - trainee
wierzenie - belief
wewnêtrzny - internal
cele szkoleniowe (l/g) - learning goals
œcie¿ka - path
konsekwentny (c) - consistent
kierownik wy¿szego szczebla (s/e) - senior executive
wiedza - knowledge
rozmaity (d) - diverse
zapytanie (e) - enquiry
pensja (s) - salary
przy³¹czyæ siê - join
bezpoœrednio (d) - directly
uwaga (a) - attention
sprzeda¿ - sales
robiæ wra¿enie - impress
na miarê - tailor-made
urz¹dzenia, udogodnienia (f) - facilities
bezpieczeñstwo (6) - safety
wspomnieæ, wymieniæ (m) - mention
trwaæ - last
szkolenie - training
godziny pracy - working hours
zachowywaæ siê - behave
oddanie, zaanga¿owanie (c) - commitment
rekrutacja - recruitment
bud¿et szkoleniowy - training budget
pasowaæ (s) - suit
bodziec - incentive
oddany, gorliwy (d) - dedicated
niezbêdny, zasadniczy (e) - essential
zespó³ - team
zatrzymaæ (r) - retain
mieæ na celu (a) - aim
okazja, sposobnoœæ (o) - opportunity
sposób (m) - manner
³owca g³ów - headhunter
ubiegaæ siê o - apply for
wymagania - requirements
niezale¿ny - independent
strona internetowa (w) - website
zarz¹dzanie czasem - time management
czêœciowo - partly
intensywny - intensive
kluczowy - key
awans - promotion
pracownik (e) - employee
w firmie, na miejscu - in-house
udaæ siê, odnieœæ sukces (s) - succeed
szybki, nag³y (r) - rapid
nadgodziny - overtime
polityka - policy
absolwent (g) - graduate
obecnie (c) - currently
rozwój, wzrost (e) - expansion
nowy pracownik (r) - recruit
prowadziæ, przewodziæ (l) - lead
sfrustrowany - frustrated
brakowaæ (l) - lack
sta³y (p) - permanent
zachêcaæ - encourage
œwiadectwo - certificate
awansowaæ (p) - promote
doskona³oœæ (e) - excellence
centrum szkoleniowe - training centre
oferta cenowa (q) - quotation
uczêszczaæ (a) - attend
okreœlanie celów (g/s) - goal setting
wspinaæ siê mozolnie po szczeblach kariery - shuffle up the ladder
profesjonalizm - professionalism
zapewniæ, dostarczyæ (p) - provide
rozpraszaæ (d) - distract
kierunek - direction
decyduj¹cy, rozstrzygaj¹cy (c) (7) - crucial
arkusz kalkulacyjny - spreadsheet
analiza - analysis
rozwój (d) - development
udany (s) - successful
kariera - career
produktywnoœæ - productivity
przywództwo (l) - leadership
chêtny (w) - willing
oczekiwaæ - expect
kultura organizacyjna - corporate culture
m³ody ambitny (h/f) - high flier
zakres (r) - range
uznanie (r) - recognition
zewnêtrzny - external
troska (c) - concern
zaawansowany - advanced
zawieraæ (i) - include
premia, dodatek (b) - bonus
personel (s) - staff
zasoby ludzkie - human resources
detalista - retailer
przypomnieæ sobie (r) - recall
ci¹g³y, sta³y, nieustaj¹cy (c) - continuous
stopieñ, ranga, stanowisko (r) - rank
cierpliwy - patient
rozwijaæ (d) - develop
pocz¹tkowy (i) - initial
fundamentalny, podstawowy (c) - core
zdobyæ (g) - gain
szczególny (p) - particular
odpowiedzialnoœæ - responsibility
wsparcie (s) - support
