przybory toaletowe - toiletries
rozwijaæ siê, powiêkszaæ siê (e) - expand
skupiæ siê na - focus on
intryga - intrigue
zainteresowanie - interest
krytykowaæ - criticise
przystêpny (a) - affordable
pojawiaæ siê - appear
posiad³oœæ (m) - mansion
rozdawaæ (h) (ph.v.) - hand out
loteria - lottery
oceniæ (e) - evaluate
lokalizacja, po³o¿enie (l) - location
szczególnie (p) - particularly
strategia marketingowa - marketing strategy
p³aciæ wy¿sz¹ cenê - pay a premium
cyfrowy - digital
t³um - crowd
kampania reklamowa - advertising campaign
zdobyæ punkty (s) - score
reklamowaæ - advertise
bezpoœrednia wysy³ka (d/m) - direct mail
dezodorant - deodorant
zaproszenie - invitation
iloœæ (q) - quantity
podarunek (g) - gift
sklep detaliczny - retail store
wschodz¹cy rynek (e/m) - emerging market
wizerunek - image
porównaæ - compare
ekscytowaæ - excite
œrodowisko, pochodzenie, wykszta³cenie (b) - background
lojalny - loyal
docelowa grupa odbiorców (t/a) - target audience
umiejêtnoœæ - skill
sponsorowanie - sponsorship
gracz - player
odpowiedni (s) - suitable
nadawaæ, emitowaæ (b) - broadcast
opis - description
po³¹czyæ (c) - combine
wyraziæ - express
twórczy - creative
poziom (l) - level
rozg³os (p) - publicity
zachêcaæ - encourage
zbiæ kapita³ na - capitalise on
przejœæ na drug¹ stronê (c) (ph.v.) - cross over
urywek (e) - extract
wada - disadvantage
cel (a) - aim
udaæ siê, powieœæ siê (s) - succeed
rozdmuchaæ, zrobiæ du¿o szumu (h) - hype
strona internetowa (w) - website
szampon - shampoo
udzia³ w rynku - market share
promowaæ - promote
dostawca - supplier
pachnieæ - smell
si³a (s) - strength
wywiesiæ (p) - post
koszty ogólne (o) - overheads
uczêszczaæ - attend
osi¹gn¹æ (r) - reach
za³o¿yæ (e) - establish
maj¹cy znaczenie, istotny, odpowiedni (r) - relevant
kierowaæ do (t) - target
wyst¹piæ (f) - feature
media spo³ecznoœciowe - social media
pewien (c) - certain
zaleta - advantage
odkrycie (d) - discovery
przyci¹gaæ (a) - attract
zwyk³y (o) - ordinary
oprogramowanie (s) - software
zastosowaæ (a) - apply
marka w³asna - own brand
swobodny (c) - casual
zale¿noœæ (r) - reliance
atrakcja - attraction
efektywnoœæ - effectiveness
sztuczka, wybieg (p) - ploy
ciekawoœæ (c) - curiosity
udany (s) - successful
segment cenowy - price segment
najwiêksza atrakcja (c) (11) - centrepiece
darmowa próbka - free sample
reklama, reklamowanie - advertising
broszura - brochure
ulotka - leaflet
zawieraæ (i) - include
rozs¹dny (s) - sensible
redukowaæ - reduce
dewiza, has³o (w) - watchword
rozpoznanie (r) - recognition
wejœæ, rozpocz¹æ (e) - enter
rozwa¿yæ (c) - consider
lojalnoœæ klienta - customer loyalty
unikalny (u) - unique
umawiaæ siê na randki - date
robiæ burzê mózgów - brainstorm
zapobiegaæ (p) - prevent
przemawiaæ do, podobaæ siê - appeal to
wytwórca, producent - manufacturer
szukaæ (s) - seek
mar¿a - profit margin
uczestnik (p) - participant
œwiadomoœæ marki - brand awareness
konkurent - competitor
wypuœciæ na rynek (l) - launch
wejœcie na stronê (h) - hit
